백아 - 테두리
카더가든 - 그날, 우리
이고도 - Mouse
박소은 - 너는 나의 문학
이강승 - 사랑이 너무 헤퍼
김새녘 - 의심
콜드 - 아무도 모르는 노래
위수 - 교토
리도어 - 사랑의 미학
Off the menu - Sunshine
백예린 - Antifreeze
나이트오프 - 잠
이희상 - 애열
혁오 - Love Ya!
검정치마 - 나랑 아니면
N@di - 편지
다섯 - ,
정우물 - blue
wave to earth - seasons
The 1975 - About You
예빛 - 소낙비
cosmic boy - 겨울(feat.선우정아&유라)
브로콜리너마저 - 이웃에 방해가 되지 않는 선에서
카더가든 - 꿈을 꿨어요
참솜 - 명왕성
김수영 - 비워내려고 합니다
BMK - 꽃피는 봄이 오면
언니네 이발관 - 가장 보통의 존재
자우림 - 스물다섯, 스물하나
가을방학 - 가끔 미치도록 네가 안고 싶어 질때가 있어
다이나믹 듀오 - 북향(feat.오혁)
colde - 벽
윤지영 - 언젠가 너와 나(feat.카더가든)
김사월 - 로맨스
Verandah Project - 기필코
딕펑스 - 바래져
AKMU - 시간과 낙엽 
아이유 - 소격동
문문 - 애월
스텔라장 - 그대는 그대로
좋아서하는밴드 - 1초 만에 만나는 방법
AKMU - 그때 그 아이들은
정키 - 홀로
옥상달빛 - 빨주노초파남보
정은지 - 하늘바라기
제이레빗 - 내일을 묻는다
요조 - 우리는 선처럼 가만히 누워
박지윤 - 봄, 여름 그 사이
자우림 - 17171771
가을방학 - 속아도 꿈결
산들 - 나의 어릴 적 이야기
제이레빗 - 선잠
넬 - 지구가 태양을 네 번
짙은 - 안개
김거지 - 조금만 더
자전거 탄 풍경 - 너에게 난 나에게 넌
10CM - 새벽 4시
올티 - 무중력
정인, 윤종신 - 오르막길
윤상 - 날 위로하려거든
원 모어 찬스 - 내안에 하늘과 숲과 그대를
타루 - 새장속의 친구
인피니트 - 그 해 여름
장범준 - 회상
나얼 - 같은 시간 속의 너
Bard - 춤추는 바람
유재하 - 사랑하기 때문에
마지막 토스트 - 불확실성에 기대어
패닉 - 기다리다
아이유 - 이런 엔딩
양희은, 김창기 - 엄마가 딸에게
안녕하신가영 - 좋아하는 마음
FTISLAND - 소녀를 만나다
보아 - 천국과 지옥 사이
프롬 - 서로의 조각
서영은 - 좋아 좋아
김진표 - 오롤롤롤로
유지희 - 누구보다 예쁘게
타루 - 날씨 맑음
허회경 - 김철수 씨 이야기 
김필선 - 마마
겸 - 운명론
카더가든 - 아무렇지 않은 사람
호소 - 나를 좋아해주지 않아도 괜찮아
오존 (O3ohn) - Down
데이먼스 이어 (Damons year) - Salty
선우정아 - 남
우리같은사람들 - 그 많던 일기는 그저 글자가 되고
혁오(HYUKOH) - TOMBOY
잔나비 - 꿈과 책과 힘과 벽
선우정아 - 그러려니